越南	竞争	古巴
孟加拉	竞争	阿尔及利亚
伊拉克	竞争	科威特
德比	竞争	利比亚
海地	竞争	坦桑尼亚
英国	竞争	巴林
越南	冲突	孟加拉
利比亚	竞争	希腊
西班牙	竞争	科威特
德国	冲突	柏林
巴西	竞争	法国
台湾	冲突	法国
美国	合作	沙巴
英国	冲突	北京
首尔	冲突	印度
德国	冲突	奥地利
法国	冲突	尼泊尔
土耳其	冲突	葡萄牙
法国	竞争	摩洛哥
莫斯科	冲突	中国
瑞士	冲突	韩国
挪威	竞争	英国
美国	冲突	新西伯利亚
日本	竞争	印度
巴斯	竞争	伊朗
印度	竞争	瑞士
瑞士	竞争	瑞典
法国	竞争	奥地利
越南	冲突	菲律宾
美国	合作	约克
“宙斯盾”舰	打击	美国海军
安32运输机	打击	苏30
AGM-114海尔法导弹	打击	美国陆军
苏-34空/海军型歼击/轰炸机	打击	苏-35
22350型护卫舰	打击	北方舰队
挪威	冲突	丹麦
意大利	冲突	匈牙利
052D型驱逐舰	配置	巡航导弹
提康德罗加级宙斯盾巡洋舰	配置	巡航导弹
“尼米兹”号	打击	美军
瑞典	冲突	英国
飞毛腿战术弹道导弹	路线	叙利亚
地空导弹	打击	T-14阿玛塔坦克
预警机	配置	空中加油机
弹道导弹	隶属	盟军
F-22	打击	美国海军航空兵“蓝天使”飞行表演队
驱逐舰	打击	巡逻炮艇
“列克星敦号”	打击	战斗机
基洛夫级核巡洋舰	打击	舰空导弹
鱼雷	路线	德国
贝卡	合作	黎巴嫩
得克萨斯号	打击	巡洋舰
歼20	协作	霹雳-10
光荣级巡洋舰莫斯科号	打击	俄罗斯海军
中国海军	打击	日本海上自卫队
委内瑞拉	合作	海地
阿利*伯克级驱逐舰	协作	相控阵雷达
俄空军	路线	北京
F-16战斗机	打击	F-117A隐形战斗机
西奥多·罗斯福号航母	打击	美国海军
阵风战斗机	打击	M777火炮
舰载机F/A-18	打击	黄蜂
挪威	竞争	朝鲜
苏-30MKI战斗机	协作	巴基斯坦空军
攀枝花	冲突	中国
远程反舰导弹	打击	舰空导弹
提康德罗加级宙斯盾巡洋舰	打击	爱国者防空导弹
俄罗斯空军	目标	越南
阵风战斗机	装备	F-35I战斗机
歼-11型战机	目标	台湾
“弗拉基米尔大公”号	打击	核潜艇
米格-24战斗直升机	打击	美国空军
尼米兹级航空母舰	打击	罗斯福号航空母舰
海上自卫队	打击	俄罗斯海军
战斗机	路线	迪拜
B-1B战略核轰炸机	装备	战略轰炸机
也门	合作	美国
潜艇	打击	中程弹道导弹
坦克武装直升机	路线	土耳其
1134B级大型反潜舰“克赤”号	打击	黑海舰队
“里根号”	打击	美军
核动力导弹巡洋舰	协作	核动力航母
美军	配置	俄罗斯空天军
苏-24M战斗轰炸机	路线	莫斯科
苏-30MKI	路线	巴基斯坦
导弹护卫舰	打击	舰艇编队
爱国者导弹	路线	美国
菲律宾	冲突	泰国
莫斯科	冲突	蒙古
米格-29	路线	哈马
核动力潜艇	打击	美国海军
伊尔-38	目标	加拿大
蛙-7	路线	美国
航空母舰	打击	法国海军
战略核潜艇“弗拉基米尔大公”号	打击	弹道导弹
轰炸机	打击	三叉戟ⅡD-5导弹
伊丽莎白女王级航空母舰	协作	英国海军
导弹艇	打击	美国海军
补给舰	打击	潜艇
亚历山大号潜艇	打击	美国海军
现代级驱逐舰	打击	超音速反舰导弹
弗拉基米尔大公号	打击	战略核潜艇
战列舰	打击	海上特攻队
无畏舰	打击	主炮
舰载机	打击	验证机
巡航导弹	打击	俄海军
尼米兹级航空母舰	打击	固定翼舰载机
澳大利亚	竞争	中国
涅夫斯基号	打击	俄海军